# Syntax highlighting for Modbus library

# Classes
ModbusMaster	KEYWORD1
ModbusRTUMaster	KEYWORD1
ModbusTCPClient	KEYWORD1
ADURTU		KEYWORD1
ADUTCP		KEYWORD1
ClientItem	KEYWORD1
SlaveBase	KEYWORD1
Slaves		KEYWORD1
Slave		KEYWORD1
PDU		KEYWORD1
ADUQueue	KEYWORD1
ADUTCPSent	KEYWORD1

# Methods
begin		KEYWORD2
loop		KEYWORD2
writeSingleCoil	KEYWORD2
writeCoils	KEYWORD2
readCoil	KEYWORD2
readCoils	KEYWORD2
readCoilsByBytes	KEYWORD2
readDiscreteInput	KEYWORD2
readDiscreteInputs	KEYWORD2
readDiscreteInputsByBytes	KEYWORD2
writeSingleHoldingRegister	KEYWORD2
writeHoldingRegister	KEYWORD2
writeHoldingRegisters	KEYWORD2
readHoldingRegister	KEYWORD2
readHoldingRegisters	KEYWORD2
readInputRegister	KEYWORD2
readInputRegisters	KEYWORD2
readExceptionStatus	KEYWORD2
maskWriteRegister	KEYWORD2
diagnostic	KEYWORD2
readWriteMultipleRegisters	KEYWORD2
addClient	KEYWORD2
getResponseTimeout	KEYWORD2
setResponseTimeout	KEYWORD2
getFrameTimeout	KEYWORD2
setFrameTimeout	KEYWORD2
getByteTimeout	KEYWORD2
setByteTimeout	KEYWORD2
set		KEYWORD2
remove		KEYWORD2
isBroadcast	KEYWORD2
setBroadcast	KEYWORD2
getRepeat	KEYWORD2
setRepeatDelay	KEYWORD2
getRepeatDelay	KEYWORD2
setDelay	KEYWORD2
getDelay	KEYWORD2
getNext		KEYWORD2
peek		KEYWORD2
getActive	KEYWORD2
resetActive	KEYWORD2
hasMore		KEYWORD2
isSet		KEYWORD2
clear		KEYWORD2

# Types
UartConfig	KEYWORD3
callback	KEYWORD3

# Constants
Mode_8N1	LITERAL1
Mode_8E1	LITERAL1
Mode_8O1	LITERAL1
Mode_8N2	LITERAL1
Mode_8E2	LITERAL1
MB_RESPONSE_TIMEOUT	LITERAL1
MB_TCP_RESPONSE_TIMEOUT	LITERAL1
MB_RECONNECT	LITERAL1
MB_EX_SUCCESS			LITERAL1
MB_EX_LIB_INVALID_SLAVE		LITERAL1
MB_EX_LIB_NO_MORE_FREE_ADU	LITERAL1
MB_EX_LIB_QUEUE_FULL		LITERAL1
MB_EX_LIB_RESPONSE_TIMEOUT	LITERAL1
MB_FC_READ_COILS		LITERAL1
MB_FC_READ_DISCRETE_INPUTS	LITERAL1
MB_FC_READ_HOLDING_REGISTERS	LITERAL1
MB_FC_READ_INPUT_REGISTERS	LITERAL1
MB_FC_WRITE_SINGLE_COIL		LITERAL1
MB_FC_WRITE_SINGLE_REGISTER	LITERAL1
MB_FC_WRITE_MULTIPLE_COILS	LITERAL1
MB_FC_WRITE_MULTIPLE_REGISTERS	LITERAL1
MB_FC_MASK_WRITE_REGISTER	LITERAL1
MB_FC_READ_WRITE_MULTIPLE_REGISTERS	LITERAL1
